wwwwwwwwwwwwwwwwwwwwwwwwwwww
w++++++++++++S+++++++++++++w
w..__....__......___.......w
w+++ttt+++++ttt+tt++++tt+ttw
wl..........l....l......ll.w
w._...._..........._...._..w
w++++++++++++++++++++++++++w
wttt+tt++++ttt+tt+ttt++++ttw
w...-......-...........-...w
w...x...xx.......x.........w
w++++++++++++++++++++++++++w
w++tt+ttt+t+++++ttt+++ttt+tw
w.-..........-...........-.w
wiiiiiiiiiiiiiiiiiiiiiiiiiiw
wwwwwwwwwwwwwwwwwwwwwwwwwwww
