wwwwwwwwwwwwwwwwwwwwwwwwwwww
w++++++++++++S+++++++++++++w
w...x....x.......x.....x...w
w...x....x.......x.....x...w
w++t+++t+++++t+++t++++t+++tw
w+ttt+ttt+++ttt+ttt++ttt+ttw
w++t+++t+++++t+++t++++t+++tw
w...x....x.......x.....x...w
w+t+t+t+t+t+t+t+tt+t+t+t+t+w
w.-..............-.....-...w
w.-..............-.....-...w
wt+++t+++++t+++t++++t+++t++w
wtt+ttt+++ttt+ttt++ttt+tt++w
wt+++t+++++t+++t++++t+++t++w
w.-......-................-w
wiiiiiiiiiiiiiiiiiiiiiiiiiiw
wwwwwwwwwwwwwwwwwwwwwwwwwwww
