wwwwwwwwwwwwwwwwwwwwwwwwwwww
w++++++++++++S+++++++++++++w
w.....__.........___.......w
w.......x........x......xx.w
w.......l........l......ll.w
wtt+++tt+++ttt+t++ttt++ttttw
w++++++++++++++++++++++++++w
w..l......l........l......lw
wll.....l........l......ll.w
w+++tttt+tttt+++++tt++ttt++w
w++++++++++++++++++++++++++w
w.-......-................-w
wiiiiiiiiiiiiiiiiiiiiiiiiiiw
wwwwwwwwwwwwwwwwwwwwwwwwwwww
