wwwwwwwwwwwwwwwwwwwwwwwwwwww
w++++++++++++S+++++++++++++w
w.....__.........___.......w
wttt+tt++++ttt+tt+ttt++++ttw
w...-......-...........-...w
w...x...xx.......x.........w
w++++++++++++++++++++++++++w
wtt+++tt+++ttt+t++ttt++ttttw
wll.....l........l......ll.w
w._...._....._.........._..w
w++++++++++++++++++++++++++w
w+++tttt+tttt+++++tt++ttt++w
w.-......-................-w
wiiiiiiiiiiiiiiiiiiiiiiiiiiw
wwwwwwwwwwwwwwwwwwwwwwwwwwww
