wwwwwwwwwwwwwwwwwwwwwwwwwwww
w++++++++++++S+++++++++++++w
w.....__........._....._...w
w.......x........x......x..w
w.....x........x......x....w
w.......l........l......l..w
w++++++++++++++++++++++++++w
w+t+++tt+++ttt+t++ttt++ttt+w
wx......x........x......x..w
w..l......l........l......lw
wl......l........l......l..w
w++++++++++++++++++++++++++w
w+++tttt+tttt+++++tt++ttt++w
w.-......-................-w
wiiiiiiiiiiiiiiiiiiiiiiiiiiw
wwwwwwwwwwwwwwwwwwwwwwwwwwww
