wwwwwwwwwwwwwwwwwwwwwwwwwwww
w++++++++++++S+++++++++++++w
w.....__.........___.......w
w+t+t+t+t+t+t+t+tt+t+t+t+t+w
w.-..............-.....-...w
w...x....x.......x.....x...w
w++++++++++++++++++++++++++w
wtt+++tt+++t+tt++t+ttt+++ttw
w...-..........-.......-...w
w...x...x...............xx.w
w++++++++++++++++++++++++++w
wttt+tt++++ttt+tt+ttt++++ttw
w.-..........-...........-.w
wiiiiiiiiiiiiiiiiiiiiiiiiiiw
wwwwwwwwwwwwwwwwwwwwwwwwwwww
